beginner2
##########
##########
##########
#####.$_##
#####.$_##
#####.#_##
##@__$__##
###___####
##########
##########