beginner4
##########
##########
####___###
###__$_###
##_____###
##.._#@_##
###_###_##
###__$__##
###_____##
##########