beginner3
##########
##########
###__#####
###___####
###__$####
###_.._###
###__$@###
###__#####
##########
##########