beginner1
##########
##########
##########
##.#######
##_$____##
##___$_@##
##_____###
##.#######
##########
##########