beginner5
##########
##########
##########
#_______##
#___#@__##
#___$.$_##
#___..$_##
#_______##
##########
##########