easy5
##########
##########
##########
####__####
##_____$_#
##_#__#$_#
##_._.#@_#
##########
##########
##########