easy2
##########
##########
##########
###__.####
###_$_####
###_.@__##
####__$_##
####___###
##########
##########
