easy4
##########
##########
###_____##
###_.$._##
###_$.$_##
###_.$._##
###_$.$_##
###__@__##
##########
##########