easy3
##########
##########
##########
###_____##
###_.$._##
###_$@$_##
##__.$._##
##______##
##########
##########