easy1
##########
##########
##########
###.__####
###@$__###
####_$_###
#####__###
#####.####
##########
##########