hard4
##########
##########
##########
#___.._###
#__@$$_###
#####_####
####__####
####__####
####__####
##########