hard5
##########
##########
##__######
##_____###
##_##___##
#._.#_@$##
#___#_$$_#
#__.#____#
##########
##########