hard2
##########
##########
##._######
##.@_#####
##._$#####
###$_#####
###_$__###
###____###
###__#####
##########