hard1
##########
##########
##########
####___###
####$$@###
##___#####
##_____###
##_._._###
##########
##########