hard3
##########
##########
##########
##__######
##_._._###
##_$$#@###
###____###
##########
##########
##########