veryhard2
##########
##########
##########
###_@_####
###...####
###$$$####
###____###
###____###
##########
##########