veryhard5
##########
##########
#___######
#_$__#####
##_$_#####
####@.__##
###__.#_##
###_____##
##########
##########