veryhard4
##########
##########
##########
###_@_####
###___####
####$_####
##_...####
##_$$_####
####__####
##########