veryhard1
##########
##########
###____###
###_##@###
###_#_$_##
#_..#_$_##
#_______##
#__#######
##########
##########