veryhard3
##########
##########
##_____###
##._.__###
##_##_####
##__$_####
####$_####
####@_####
####__####
##########